y

g g b b b
y y y r r
g y y r y
g b b g y
r r g g y
