o

o o o v p p
p p o v c g
y y y c c g


g v g g y v
g v y y g v
g o o v v p
