r

c g g g o o o
p c c g b   v
p c   y b v v
v c y y y c c
v r r c c c p
v r r r   y p
