?

  y y           p
  r r         p p
  r o o b b r y b
    o   b g y r r
M   o y g g g   v
c c p p   p c v v
c   o p p p c c c g
      p         c g
    M y y         M
